###########
#M#########
# ###     #
# #   #####
#        I#
###########
